02 02 02 02 02 02 02 00 02 02 02 02 02 02 02 00 02 02 02 02 02 01 02 02 02 02 02
02 02 02 02 02 02 02 00 02 02 02 02 02 02 02 00 02 02 02 02 02 01 02 02 02 02 02
02 02 02 02 02 02 02 00 02 02 02 02 02 02 02 00 02 02 02 02 02 01 02 02 02 02 02
02 02 02 02 02 02 02 00 02 02 02 02 02 02 02 00 02 02 02 02 02 01 02 02 02 02 02
02 02 02 02 02 02 02 00 02 02 02 02 02 02 02 00 02 02 02 02 02 01 02 02 02 02 02
02 02 02 02 02 02 02 00 02 02 02 02 02 02 02 00 02 02 02 02 02 01 02 02 02 02 02
02 02 02 02 02 02 02 00 02 02 02 02 02 02 02 00 02 02 02 02 02 01 02 02 02 02 02
02 02 02 02 02 02 02 00 02 02 02 02 02 02 02 00 02 02 02 02 02 01 02 02 02 02 02
02 02 02 02 02 02 02 00 02 02 02 02 02 02 02 00 02 02 02 02 02 01 02 02 02 02 02
02 02 02 02 02 02 02 00 02 02 02 02 02 02 02 00 02 02 02 02 02 01 02 02 02 02 02
00 00 00 00 00 00 00 00 02 02 02 02 02 02 02 00 02 03 02 02 02 01 02 02 02 02 02
02 02 06 02 02 02 02 00 02 02 02 02 02 02 02 00 02 02 02 02 02 01 02 02 02 02 02
02 02 02 02 02 02 02 00 02 02 02 02 02 04 02 00 02 02 02 02 02 01 02 02 02 02 02
02 02 02 02 02 02 02 00 02 02 02 02 02 02 02 00 02 02 02 02 02 01 02 02 02 02 02
