01 01 01 01 01 01 01 01 01 01 01 01 01 01 01 01 00 01 01 01 01 01 01 01 01 01 01
02 02 02 02 02 02 02 02 02 02 02 02 02 02 02 02 04 02 02 02 02 02 02 01 02 02 02
02 02 02 02 08 02 02 02 02 02 02 02 02 02 02 02 00 02 02 02 02 02 02 02 02 02 02
02 02 02 02 02 02 02 02 02 02 02 02 02 02 02 02 00 02 02 02 02 02 02 01 02 02 02
02 02 02 02 02 02 02 02 02 02 02 02 02 02 02 02 00 02 02 02 02 02 02 01 02 02 02
02 02 02 02 02 02 02 02 02 02 02 02 02 02 02 02 00 02 02 02 02 02 02 01 02 02 02
02 02 02 02 02 02 02 02 02 02 02 02 02 02 02 02 00 02 02 02 02 02 02 01 02 02 02
02 02 02 02 02 02 02 02 02 02 02 02 02 02 02 02 00 02 03 02 02 02 02 01 02 02 02
02 02 02 02 02 02 02 02 02 02 02 02 02 09 02 02 00 02 02 02 02 02 02 01 02 02 02
02 02 02 02 06 02 02 02 02 02 02 02 02 02 02 02 00 02 02 02 02 02 02 01 02 02 02
02 02 05 02 02 02 02 02 02 02 02 02 02 02 02 02 00 02 02 02 02 02 02 02 02 02 02
02 02 02 02 02 02 02 02 02 02 02 09 02 02 02 02 00 02 02 02 02 02 02 01 02 02 02
02 02 02 02 02 02 02 02 02 02 02 02 02 02 02 02 00 02 02 02 02 02 02 01 01 01 01
02 02 02 02 02 02 02 02 02 02 02 02 02 02 07 02 00 02 02 02 02 02 01 01 01 01 01
